
________________________  Row
|          |1|         |   1
|          |0|         |   2
|          |0|         |   3
| |0||0||3||0|         |   4
| |0|   |0|            |   5
| |0|   |0|            |   6
| |3||0||0||0||0|      |   7
|          |M|         |   8
|       |0||0||0|      |   9
|       |0|            |  10
|       |E|            |  11
________________________
   1  2  3  4  5  6  7
Column